___XX_X_
_X__X___
SXX___X_
_X__X___
___XX_X_
_X__X_X_
_XX___X_
__G_X___